##################################################
##################################################
##################################################
##################################################
##################################################
##################################################
##################################################
##################################################
##########                              ##########
##########                              ##########
##########                              ##########
##########                              ##########
##########                              ##########
##########                              ##########
##########                              ##########
##########                              ##########
##########                              ##########
##########                              ##########
##########                              ##########
##########                              ##########
##########                              ##########
##########                              ##########
##########                              ##########
##########                              ##########
##########                              ##########
##########                              ##########
##########                              ##########
##########                              ##########
##########                              ##########
##########                              ##########
##########                              ##########
##########                              ##########
##########                              ##########
##########                              ##########
##########                              ##########
##########                              ##########
##########               E              ##########
##########                              ##########
##########                              ##########
##########                              ##########
##########                              ##########
##################################################
##################################################
##################################################
##################################################
##################################################
##################################################
##################################################
##################################################
##################################################
